#I###########################
# ############        #######
#              ###### #######
############ ######## #######
###    B      ########    ####
### ##### ############## ####
### ##    ###################
### ## ##  ##################
###    ###       ############
######    ##### #############
#          ####       #######
#X###########################