#I###########################
# ############        #######
#              ###### #######
############ ######## #######
###    B      ########   ####
### ##### #######      # ####
### ##    ####### ###### ####
### ## ##  ######   ####    #
###    ###       ## #########
######    ##### ### #########
#          ####       #######
#X###########################